32
9
................................
................................
................W...............
................W...............
...P............W...............
________________________________
________________________________
________________________________
________________________________