32
9
....................WWWWWWW.....
................................
................W...............
................W...............
...P............W.....TTT.....X.
________________________________
________________________________
________________________________
________________________________